aar 	aar 	aa 	Afar
abk 	abk 	ab 	Abkhazian
afr 	afr 	af 	Afrikaans
aka 	aka 	ak 	Akan
amh 	amh 	am 	Amharic
ara 	ara 	ar 	Arabic
arg 	arg 	an 	Aragonese
asm 	asm 	as 	Assamese
ava 	ava 	av 	Avaric
ave 	ave 	ae 	Avestan
aym 	aym 	ay 	Aymara
aze 	aze 	az 	Azerbaijani
bak 	bak 	ba 	Bashkir
bam 	bam 	bm 	Bambara
bel 	bel 	be 	Belarusian
ben 	ben 	bn 	Bengali
bis 	bis 	bi 	Bislama
bod 	bod 	bo 	Tibetan
bos 	bos 	bs 	Bosnian
bre 	bre 	br 	Breton
bul 	bul 	bg 	Bulgarian
cat 	cat 	ca 	Catalan, Valencian
ces 	ces     cs 	Czech
cha 	cha 	ch 	Chamorro
che 	che 	ce 	Chechen
chu 	chu 	cu 	Church Slavic, Church Slavonic, Old Bulgarian, Old Church Slavonic, Old Slavonic
chv 	chv 	cv 	Chuvash
cor 	cor 	kw 	Cornish
cos 	cos 	co 	Corsican
cre 	cre 	cr 	Cree
cym 	cym     cy 	Welsh
dan 	dan 	da 	Danish
deu 	deu     de 	German
div 	div 	dv 	Dhivehi, Divehi, Maldivian
dzo 	dzo 	dz 	Dzongkha
ell 	gre 	el 	Modern Greek (1453-)
eng 	eng 	en 	English
epo 	epo 	eo 	Esperanto
est 	est 	et 	Estonian
eus 	baq 	eu 	Basque
ewe 	ewe 	ee 	Ewe
fao 	fao 	fo 	Faroese
fas 	per 	fa 	Persian
fij 	fij 	fj 	Fijian
fin 	fin 	fi 	Finnish
fra 	fre 	fr 	French
fry 	fry 	fy 	Western Frisian
ful 	ful 	ff 	Fulah
gla 	gla 	gd 	Gaelic, Scottish Gaelic
gle 	gle 	ga 	Irish
glg 	glg 	gl 	Galician
glv 	glv 	gv 	Manx
grn 	grn 	gn 	Guarani
guj 	guj 	gu 	Gujarati
hat 	hat 	ht 	Haitian, Haitian Creole
hau 	hau 	ha 	Hausa
hbs 	sh      sh  Serbo-Croatian
heb 	heb 	he 	Hebrew
her 	her 	hz 	Herero
hin 	hin 	hi 	Hindi
hmo 	hmo 	ho 	Hiri Motu
hrv 	hrv 	hr 	Croatian
hun 	hun 	hu 	Hungarian
hye 	arm 	hy 	Armenian
ibo 	ibo 	ig 	Igbo
ido 	ido 	io 	Ido
iii 	iii 	ii 	Nuosu, Sichuan Yi
iku 	iku 	iu 	Inuktitut
ile 	ile 	ie 	Interlingue, Occidental
ina 	ina 	ia 	Interlingua (International Auxiliary Language Association)
ind 	ind 	id 	Indonesian
ipk 	ipk 	ik 	Inupiaq
isl 	ice 	is 	Icelandic
ita 	ita 	it 	Italian
jav 	jav 	jv 	Javanese
jpn 	jpn 	ja 	Japanese
kal 	kal 	kl 	Greenlandic, Kalaallisut
kan 	kan 	kn 	Kannada
kas 	kas 	ks 	Kashmiri
kat 	geo 	ka 	Georgian
kau 	kau 	kr 	Kanuri
kaz 	kaz 	kk 	Kazakh
khm 	khm 	km 	Central Khmer, Khmer
kik 	kik 	ki 	Gikuyu, Kikuyu
kin 	kin 	rw 	Kinyarwanda
kir 	kir 	ky 	Kirghiz, Kyrgyz
kom 	kom 	kv 	Komi
kon 	kon 	kg 	Kongo
kor 	kor 	ko 	Korean
kua 	kua 	kj 	Kuanyama, Kwanyama
kur 	kur 	ku 	Kurdish
lao 	lao 	lo 	Lao
lat 	lat 	la 	Latin
lav 	lav 	lv 	Latvian
lim 	lim 	li 	Limburgan, Limburger, Limburgish
lin 	lin 	ln 	Lingala
lit 	lit 	lt 	Lithuanian
ltz 	ltz 	lb 	Letzeburgesch, Luxembourgish
lub 	lub 	lu 	Luba-Katanga
lug 	lug 	lg 	Ganda
mah 	mah 	mh 	Marshallese
mal 	mal 	ml 	Malayalam
mar 	mar 	mr 	Marathi
mkd 	mac 	mk 	Macedonian
mlg 	mlg 	mg 	Malagasy
mlt 	mlt 	mt 	Maltese
mon 	mon 	mn 	Mongolian
mri 	mao 	mi 	Maori
msa 	may 	ms 	Malay (macrolanguage)
mya 	bur 	my 	Burmese
nau 	nau 	na 	Nauru
nav 	nav 	nv 	Navaho, Navajo
nbl 	nbl 	nr 	South Ndebele
nde 	nde 	nd 	North Ndebele
ndo 	ndo 	ng 	Ndonga
nep 	nep 	ne 	Nepali (macrolanguage)
nld 	dut 	nl 	Dutch, Flemish
nno 	nno 	nn 	Norwegian Nynorsk
nob 	nob 	nb 	Norwegian Bokmål
nor 	nor 	no 	Norwegian
nya 	nya 	ny 	Chewa, Chichewa, Nyanja
oci 	oci 	oc 	Occitan (post 1500)
oji 	oji 	oj 	Ojibwa
ori 	ori 	or 	Oriya (macrolanguage)
orm 	orm 	om 	Oromo
oss 	oss 	os 	Ossetian, Ossetic
pan 	pan 	pa 	Panjabi, Punjabi
pli 	pli 	pi 	Pali
pol 	pol 	pl 	Polish
por 	por 	pt 	Portuguese
pus 	pus 	ps 	Pashto, Pushto
que 	que 	qu 	Quechua
roh 	roh 	rm 	Romansh
ron 	rum 	ro 	Moldavian, Moldovan, Romanian
run 	run 	rn 	Rundi
rus 	rus 	ru 	Russian
sag 	sag 	sg 	Sango
san 	san 	sa 	Sanskrit
sin 	sin 	si 	Sinhala, Sinhalese
slk 	slo 	sk 	Slovak
slv 	slv 	sl 	Slovenian
sme 	sme 	se 	Northern Sami
smo 	smo 	sm 	Samoan
sna 	sna 	sn 	Shona
snd 	snd 	sd 	Sindhi
som 	som 	so 	Somali
sot 	sot 	st 	Southern Sotho
spa 	spa 	es 	Castilian, Spanish
sqi 	alb 	sq 	Albanian
srd 	srd 	sc 	Sardinian
srp 	srp 	sr 	Serbian
ssw 	ssw 	ss 	Swati
sun 	sun 	su 	Sundanese
swa 	swa 	sw 	Swahili (macrolanguage)
swe 	swe 	sv 	Swedish
tah 	tah 	ty 	Tahitian
tam 	tam 	ta 	Tamil
tat 	tat 	tt 	Tatar
tel 	tel 	te 	Telugu
tgk 	tgk 	tg 	Tajik
tgl 	tgl 	tl 	Tagalog
tha 	tha 	th 	Thai
tir 	tir 	ti 	Tigrinya
ton 	ton 	to 	Tonga (Tonga Islands)
tsn 	tsn 	tn 	Tswana
tso 	tso 	ts 	Tsonga
tuk 	tuk 	tk 	Turkmen
tur 	tur 	tr 	Turkish
twi 	twi 	tw 	Twi
uig 	uig 	ug 	Uighur, Uyghur
ukr 	ukr 	uk 	Ukrainian
urd 	urd 	ur 	Urdu
uzb 	uzb 	uz 	Uzbek
ven 	ven 	ve 	Venda
vie 	vie 	vi 	Vietnamese
vol 	vol 	vo 	Volapük
wln 	wln 	wa 	Walloon
wol 	wol 	wo 	Wolof
xho 	xho 	xh 	Xhosa 639-3 	
yid 	yid 	yi 	Yiddish
yor 	yor 	yo 	Yoruba
zha 	zha 	za 	Chuang, Zhuang
zho 	chi 	zh 	Chinese
zul 	zul 	zu 	Zulu 